11 24
_______________________
           __________  |
|__  |    |      ____| |   
   | |____| | | |____  |
   |________| |____  | |
        ___________| | |
        |  __________| |
________| |            |
__________|            |
_______________________|
